# === MODES ===

интерактивный	SET_INTERACTIVE_MODE
интерактивный режим	SET_INTERACTIVE_MODE
интерактив	SET_INTERACTIVE_MODE
интерактив режим	SET_INTERACTIVE_MODE
режим беседа	SET_INTERACTIVE_MODE
диалог	SET_INTERACTIVE_MODE
общение	SET_INTERACTIVE_MODE
чат	SET_INTERACTIVE_MODE
режим диалог	SET_INTERACTIVE_MODE
режим общение	SET_INTERACTIVE_MODE
режим чат	SET_INTERACTIVE_MODE

обычный режим	SET_NORMAL_MODE
обычный	SET_NORMAL_MODE
стандартный режим	SET_NORMAL_MODE
стандартный	SET_NORMAL_MODE
стандарт	SET_NORMAL_MODE
нормальный режим	SET_NORMAL_MODE
нормальный	SET_NORMAL_MODE
сброс режим	SET_NORMAL_MODE
сброс	SET_NORMAL_MODE
сбросить режим	SET_NORMAL_MODE
сбросить	SET_NORMAL_MODE